adas,f_pron	asO:amU:amUH:amUm:amU:amUH:amuyA:amUByAm:amUBiH:amuzyE:amUByAm:amUByaH:amuzyAH:amUByAm:amUByaH:amuzyAH:amuyoH:amUzAm:amuzyAm:amuyoH:amUzu:asO:amU:amUH
adas,m_pron	asO:amU:amI:amum:amU:amUn:amunA:amUByAm:amIBiH:amuzmE:amUByAm:amIByaH:amuzmAt:amUByAm:amIByaH:amuzya:amuyoH:amIzAm:amuzmin:amuyoH:amIzu:asO:amU:amI
adas,n_pron	adaH:amU:amUni:adaH:amU:amUni:amunA:amUByAm:amIBiH:amuzmE:amUByAm:amIByaH:amuzmAt:amUByAm:amIByaH:amuzya:amuyoH:amIzAm:amuzmin:amuyoH:amIzu:adaH:amU:amUni
aDara,f_pron	aDarA:aDare:aDarAH:aDarAm:aDare:aDarAH:aDarayA:aDarAByAm:aDarABiH:aDarasyE:aDarAByAm:aDarAByaH:aDarasyAH:aDarAByAm:aDarAByaH:aDarasyAH:aDarayoH:aDarAsAm:aDarasyAm:aDarayoH:aDarAsu:aDare:aDare:aDarAH
aDara,m_pron	aDaraH:aDarO:aDarAH/aDare:aDaram:aDarO:aDarAn:aDareRa:aDarAByAm:aDarEH:aDarasmE:aDarAByAm:aDareByaH:aDarAt/aDarasmAt:aDarAByAm:aDareByaH:aDarasya:aDarayoH:aDarezAm:aDare/aDarasmin:aDarayoH:aDarezu:aDara:aDarO:aDarAH/aDare
aDara,n_pron	aDaram:aDare:aDarARi:aDaram:aDare:aDarARi:aDareRa:aDarAByAm:aDarEH:aDarasmE:aDarAByAm:aDareByaH:aDarAt/aDarasmAt:aDarAByAm:aDareByaH:aDarasya:aDarayoH:aDarezAm:aDare/aDarasmin:aDarayoH:aDarezu:aDara:aDare:aDarARi
antara,f_pron	antarA:antare:antarAH:antarAm:antare:antarAH:antarayA:antarAByAm:antarABiH:antarasyE:antarAByAm:antarAByaH:antarasyAH:antarAByAm:antarAByaH:antarasyAH:antarayoH:antarAsAm:antarasyAm:antarayoH:antarAsu:antare:antare:antarAH
antara,m_pron	antaraH:antarO:antarAH/antare:antaram:antarO:antarAn:antareRa:antarAByAm:antarEH:antarasmE:antarAByAm:antareByaH:antarAt/antarasmAt:antarAByAm:antareByaH:antarasya:antarayoH:antarezAm:antare/antarasmin:antarayoH:antarezu:antara:antarO:antarAH/antare
antara,n_pron	antaram:antare:antarARi:antaram:antare:antarARi:antareRa:antarAByAm:antarEH:antarasmE:antarAByAm:antareByaH:antarAt/antarasmAt:antarAByAm:antareByaH:antarasya:antarayoH:antarezAm:antare/antarasmin:antarayoH:antarezu:antara:antare:antarARi
anya,f_pron	anyA:anye:anyAH:anyAm:anye:anyAH:anyayA:anyAByAm:anyABiH:anyasyE:anyAByAm:anyAByaH:anyasyAH:anyAByAm:anyAByaH:anyasyAH:anyayoH:anyAsAm:anyasyAm:anyayoH:anyAsu:anye:anye:anyAH
anya,m_pron	anyaH:anyO:anye:anyam:anyO:anyAn:anyena:anyAByAm:anyEH:anyasmE:anyAByAm:anyeByaH:anyasmAt:anyAByAm:anyeByaH:anyasya:anyayoH:anyezAm:anyasmin:anyayoH:anyezu:anya:anyO:anye
anya,n_pron	anyat:anye:anyAni:anyat:anye:anyAni:anyena:anyAByAm:anyEH:anyasmE:anyAByAm:anyeByaH:anyasmAt:anyAByAm:anyeByaH:anyasya:anyayoH:anyezAm:anyasmin:anyayoH:anyezu:anyat:anye:anyAni
anyatama,f_pron	anyatamA:anyatame:anyatamAH:anyatamAm:anyatame:anyatamAH:anyatamayA:anyatamAByAm:anyatamABiH:anyatamasyE:anyatamAByAm:anyatamAByaH:anyatamasyAH:anyatamAByAm:anyatamAByaH:anyatamasyAH:anyatamayoH:anyatamAsAm:anyatamasyAm:anyatamayoH:anyatamAsu:anyatame:anyatame:anyatamAH
anyatama,m_pron	anyatamaH:anyatamO:anyatame:anyatamam:anyatamO:anyatamAn:anyatamena:anyatamAByAm:anyatamEH:anyatamasmE:anyatamAByAm:anyatameByaH:anyatamasmAt:anyatamAByAm:anyatameByaH:anyatamasya:anyatamayoH:anyatamezAm:anyatamasmin:anyatamayoH:anyatamezu:anyatama:anyatamO:anyatame
anyatama,n_pron	anyatamat:anyatame:anyatamAni:anyatamat:anyatame:anyatamAni:anyatamena:anyatamAByAm:anyatamEH:anyatamasmE:anyatamAByAm:anyatameByaH:anyatamasmAt:anyatamAByAm:anyatameByaH:anyatamasya:anyatamayoH:anyatamezAm:anyatamasmin:anyatamayoH:anyatamezu:anyatamat:anyatame:anyatamAni
anyatara,f_pron	anyatarA:anyatare:anyatarAH:anyatarAm:anyatare:anyatarAH:anyatarayA:anyatarAByAm:anyatarABiH:anyatarasyE:anyatarAByAm:anyatarAByaH:anyatarasyAH:anyatarAByAm:anyatarAByaH:anyatarasyAH:anyatarayoH:anyatarAsAm:anyatarasyAm:anyatarayoH:anyatarAsu:anyatare:anyatare:anyatarAH
anyatara,m_pron	anyataraH:anyatarO:anyatare:anyataram:anyatarO:anyatarAn:anyatareRa:anyatarAByAm:anyatarEH:anyatarasmE:anyatarAByAm:anyatareByaH:anyatarasmAt:anyatarAByAm:anyatareByaH:anyatarasya:anyatarayoH:anyatarezAm:anyatarasmin:anyatarayoH:anyatarezu:anyatara:anyatarO:anyatare
anyatara,n_pron	anyatarat:anyatare:anyatarARi:anyatarat:anyatare:anyatarARi:anyatareRa:anyatarAByAm:anyatarEH:anyatarasmE:anyatarAByAm:anyatareByaH:anyatarasmAt:anyatarAByAm:anyatareByaH:anyatarasya:anyatarayoH:anyatarezAm:anyatarasmin:anyatarayoH:anyatarezu:anyatarat:anyatare:anyatarARi
apara,f_pron	aparA:apare:aparAH:aparAm:apare:aparAH:aparayA:aparAByAm:aparABiH:aparasyE:aparAByAm:aparAByaH:aparasyAH:aparAByAm:aparAByaH:aparasyAH:aparayoH:aparAsAm:aparasyAm:aparayoH:aparAsu:apare:apare:aparAH
apara,m_pron	aparaH:aparO:aparAH/apare:aparam:aparO:aparAn:apareRa:aparAByAm:aparEH:aparasmE:aparAByAm:apareByaH:aparAt/aparasmAt:aparAByAm:apareByaH:aparasya:aparayoH:aparezAm:apare/aparasmin:aparayoH:aparezu:apara:aparO:aparAH/apare
apara,n_pron	aparam:apare:aparARi:aparam:apare:aparARi:apareRa:aparAByAm:aparEH:aparasmE:aparAByAm:apareByaH:aparAt/aparasmAt:aparAByAm:apareByaH:aparasya:aparayoH:aparezAm:apare/aparasmin:aparayoH:aparezu:apara:apare:aparARi
avara,f_pron	avarA:avare:avarAH:avarAm:avare:avarAH:avarayA:avarAByAm:avarABiH:avarasyE:avarAByAm:avarAByaH:avarasyAH:avarAByAm:avarAByaH:avarasyAH:avarayoH:avarAsAm:avarasyAm:avarayoH:avarAsu:avare:avare:avarAH
avara,m_pron	avaraH:avarO:avarAH/avare:avaram:avarO:avarAn:avareRa:avarAByAm:avarEH:avarasmE:avarAByAm:avareByaH:avarAt/avarasmAt:avarAByAm:avareByaH:avarasya:avarayoH:avarezAm:avare/avarasmin:avarayoH:avarezu:avara:avarO:avarAH/avare
avara,n_pron	avaram:avare:avarARi:avaram:avare:avarARi:avareRa:avarAByAm:avarEH:avarasmE:avarAByAm:avareByaH:avarAt/avarasmAt:avarAByAm:avareByaH:avarasya:avarayoH:avarezAm:avare/avarasmin:avarayoH:avarezu:avara:avare:avarARi
asmad,m_pron	aham:Avam/AvAm:vayam:mAm/mA:AvAm/nO:asmAn/naH:mayA:AvAByAm:asmABiH:mahyam/me:AvAByAm/nO:asmaByam/naH:mat:AvAByAm:asmat:mama/me:AvayoH/nO:asmAkam/naH:mayi:AvayoH:asmAsu:aham:Avam/AvAm:vayam
itara,f_pron	itarA:itare:itarAH:itarAm:itare:itarAH:itarayA:itarAByAm:itarABiH:itarasyE:itarAByAm:itarAByaH:itarasyAH:itarAByAm:itarAByaH:itarasyAH:itarayoH:itarAsAm:itarasyAm:itarayoH:itarAsu:itare:itare:itarAH
itara,m_pron	itaraH:itarO:itare:itaram:itarO:itarAn:itareRa:itarAByAm:itarEH:itarasmE:itarAByAm:itareByaH:itarasmAt:itarAByAm:itareByaH:itarasya:itarayoH:itarezAm:itarasmin:itarayoH:itarezu:itara:itarO:itare
itara,n_pron	itarat:itare:itarARi:itarat:itare:itarARi:itareRa:itarAByAm:itarEH:itarasmE:itarAByAm:itareByaH:itarasmAt:itarAByAm:itareByaH:itarasya:itarayoH:itarezAm:itarasmin:itarayoH:itarezu:itarat:itare:itarARi
idam,f_pron	iyam:ime:imAH:imAm/enAm:ime/ene:imAH/enAH:anayA/enayA:AByAm:ABiH:asyE:AByAm:AByaH:asyAH:AByAm:AByaH:asyAH:anayoH/enayoH:AsAm:asyAm:anayoH/enayoH:Asu:iyam:ime:imAH
idam,m_pron	ayam:imO:ime:imam/enam:imO/enO:imAn/enAn:anena/enena:AByAm:eBiH:asmE:AByAm:eByaH:asmAt:AByAm:eByaH:asya:anayoH/enayoH:ezAm:asmin:anayoH/enayoH:ezu:ayam:imO:ime
idam,n_pron	idam:ime:imAni:idam/enat:ime/ene:imAni/enAni:anena/enena:AByAm:eBiH:asmE:AByAm:eByaH:asmAt:AByAm:eByaH:asya:anayoH/enayoH:ezAm:asmin:anayoH/enayoH:ezu:idam:ime:imAni
uttara,f_pron	uttarA:uttare:uttarAH:uttarAm:uttare:uttarAH:uttarayA:uttarAByAm:uttarABiH:uttarasyE:uttarAByAm:uttarAByaH:uttarasyAH:uttarAByAm:uttarAByaH:uttarasyAH:uttarayoH:uttarAsAm:uttarasyAm:uttarayoH:uttarAsu:uttare:uttare:uttarAH
uttara,m_pron	uttaraH:uttarO:uttarAH/uttare:uttaram:uttarO:uttarAn:uttareRa:uttarAByAm:uttarEH:uttarasmE:uttarAByAm:uttareByaH:uttarAt/uttarasmAt:uttarAByAm:uttareByaH:uttarasya:uttarayoH:uttarezAm:uttare/uttarasmin:uttarayoH:uttarezu:uttara:uttarO:uttarAH/uttare
uttara,n_pron	uttaram:uttare:uttarARi:uttaram:uttare:uttarARi:uttareRa:uttarAByAm:uttarEH:uttarasmE:uttarAByAm:uttareByaH:uttarAt/uttarasmAt:uttarAByAm:uttareByaH:uttarasya:uttarayoH:uttarezAm:uttare/uttarasmin:uttarayoH:uttarezu:uttara:uttare:uttarARi
uBa,f_pron	uBA:uBe:uBAH:uBAm:uBe:uBAH:uBayA:uBAByAm:uBABiH:uBasyE:uBAByAm:uBAByaH:uBasyAH:uBAByAm:uBAByaH:uBasyAH:uBayoH:uBAsAm:uBasyAm:uBayoH:uBAsu:uBe:uBe:uBAH
uBa,m_pron	uBaH:uBO:uBe:uBam:uBO:uBAn:uBeRa:uBAByAm:uBEH:uBasmE:uBAByAm:uBeByaH:uBasmAt:uBAByAm:uBeByaH:uBasya:uBayoH:uBezAm:uBasmin:uBayoH:uBezu:uBa:uBO:uBe
uBa,n_pron	uBam:uBe:uBARi:uBam:uBe:uBARi:uBeRa:uBAByAm:uBEH:uBasmE:uBAByAm:uBeByaH:uBasmAt:uBAByAm:uBeByaH:uBasya:uBayoH:uBezAm:uBasmin:uBayoH:uBezu:uBa:uBe:uBARi
uBaya,f_pron	uBayA:uBaye:uBayAH:uBayAm:uBaye:uBayAH:uBayayA:uBayAByAm:uBayABiH:uBayasyE:uBayAByAm:uBayAByaH:uBayasyAH:uBayAByAm:uBayAByaH:uBayasyAH:uBayayoH:uBayAsAm:uBayasyAm:uBayayoH:uBayAsu:uBaye:uBaye:uBayAH
uBaya,m_pron	uBayaH:uBayO:uBaye:uBayam:uBayO:uBayAn:uBayeRa:uBayAByAm:uBayEH:uBayasmE:uBayAByAm:uBayeByaH:uBayasmAt:uBayAByAm:uBayeByaH:uBayasya:uBayayoH:uBayezAm:uBayasmin:uBayayoH:uBayezu:uBaya:uBayO:uBaye
uBaya,n_pron	uBayam:uBaye:uBayARi:uBayam:uBaye:uBayARi:uBayeRa:uBayAByAm:uBayEH:uBayasmE:uBayAByAm:uBayeByaH:uBayasmAt:uBayAByAm:uBayeByaH:uBayasya:uBayayoH:uBayezAm:uBayasmin:uBayayoH:uBayezu:uBaya:uBaye:uBayARi
eka,f_pron	ekA:eke:ekAH:ekAm:eke:ekAH:ekayA:ekAByAm:ekABiH:ekasyE:ekAByAm:ekAByaH:ekasyAH:ekAByAm:ekAByaH:ekasyAH:ekayoH:ekAsAm:ekasyAm:ekayoH:ekAsu:eke:eke:ekAH
eka,m_pron	ekaH:ekO:eke:ekam:ekO:ekAn:ekena:ekAByAm:ekEH:ekasmE:ekAByAm:ekeByaH:ekasmAt:ekAByAm:ekeByaH:ekasya:ekayoH:ekezAm:ekasmin:ekayoH:ekezu:eka:ekO:eke
eka,n_pron	ekam:eke:ekAni:ekam:eke:ekAni:ekena:ekAByAm:ekEH:ekasmE:ekAByAm:ekeByaH:ekasmAt:ekAByAm:ekeByaH:ekasya:ekayoH:ekezAm:ekasmin:ekayoH:ekezu:eka:eke:ekAni
etad,f_pron	ezA:ete:etAH:etAm/enAm:ete/ene:etAH/enAH:etayA/enayA:etAByAm:etABiH:etasyE:etAByAm:etAByaH:etasyAH:etAByAm:etAByaH:etasyAH:etayoH/enayoH:etAsAm:etasyAm:etayoH/enayoH:etAsu:eze:ete:etAH
etad,m_pron	ezaH:etO:ete:etam/enam:etO/enO:etAn/enAn:etena/enena:etAByAm:etEH:etasmE:etAByAm:eteByaH:etasmAt:etAByAm:eteByaH:etasya:etayoH/enayoH:etezAm:etasmin:etayoH/enayoH:etezu:eza:etO:ete
etad,n_pron	etat:ete:etAni:etat/enat:ete/ene:etAni/enAni:etena/enena:etAByAm:etEH:etasmE:etAByAm:eteByaH:etasmAt:etAByAm:eteByaH:etasya:etayoH/enayoH:etezAm:etasmin:etayoH/enayoH:etezu:etat:ete:etAni
katama,f_pron	katamA:katame:katamAH:katamAm:katame:katamAH:katamayA:katamAByAm:katamABiH:katamasyE:katamAByAm:katamAByaH:katamasyAH:katamAByAm:katamAByaH:katamasyAH:katamayoH:katamAsAm:katamasyAm:katamayoH:katamAsu:katame:katame:katamAH
katama,m_pron	katamaH:katamO:katame:katamam:katamO:katamAn:katamena:katamAByAm:katamEH:katamasmE:katamAByAm:katameByaH:katamasmAt:katamAByAm:katameByaH:katamasya:katamayoH:katamezAm:katamasmin:katamayoH:katamezu:katama:katamO:katame
katama,n_pron	katamat:katame:katamAni:katamat:katame:katamAni:katamena:katamAByAm:katamEH:katamasmE:katamAByAm:katameByaH:katamasmAt:katamAByAm:katameByaH:katamasya:katamayoH:katamezAm:katamasmin:katamayoH:katamezu:katamat:katame:katamAni
katara,f_pron	katarA:katare:katarAH:katarAm:katare:katarAH:katarayA:katarAByAm:katarABiH:katarasyE:katarAByAm:katarAByaH:katarasyAH:katarAByAm:katarAByaH:katarasyAH:katarayoH:katarAsAm:katarasyAm:katarayoH:katarAsu:katare:katare:katarAH
katara,m_pron	kataraH:katarO:katare:kataram:katarO:katarAn:katareRa:katarAByAm:katarEH:katarasmE:katarAByAm:katareByaH:katarasmAt:katarAByAm:katareByaH:katarasya:katarayoH:katarezAm:katarasmin:katarayoH:katarezu:katara:katarO:katare
katara,n_pron	katarat:katare:katarARi:katarat:katare:katarARi:katareRa:katarAByAm:katarEH:katarasmE:katarAByAm:katareByaH:katarasmAt:katarAByAm:katareByaH:katarasya:katarayoH:katarezAm:katarasmin:katarayoH:katarezu:katarat:katare:katarARi
kim,f_pron	kA:ke:kAH:kAm:ke:kAH:kayA:kAByAm:kABiH:kasyE:kAByAm:kAByaH:kasyAH:kAByAm:kAByaH:kasyAH:kayoH:kAsAm:kasyAm:kayoH:kAsu:ke:ke:kAH
kim,m_pron	kaH:kO:ke:kam:kO:kAn:kena:kAByAm:kEH:kasmE:kAByAm:keByaH:kasmAt:kAByAm:keByaH:kasya:kayoH:kezAm:kasmin:kayoH:kezu:ka:kO:ke
kim,n_pron	kim:ke:kAni:kim:ke:kAni:kena:kAByAm:kEH:kasmE:kAByAm:keByaH:kasmAt:kAByAm:keByaH:kasya:kayoH:kezAm:kasmin:kayoH:kezu:kim:ke:kAni
tatama,f_pron	tatamA:tatame:tatamAH:tatamAm:tatame:tatamAH:tatamayA:tatamAByAm:tatamABiH:tatamasyE:tatamAByAm:tatamAByaH:tatamasyAH:tatamAByAm:tatamAByaH:tatamasyAH:tatamayoH:tatamAsAm:tatamasyAm:tatamayoH:tatamAsu:tatame:tatame:tatamAH
tatama,m_pron	tatamaH:tatamO:tatame:tatamam:tatamO:tatamAn:tatamena:tatamAByAm:tatamEH:tatamasmE:tatamAByAm:tatameByaH:tatamasmAt:tatamAByAm:tatameByaH:tatamasya:tatamayoH:tatamezAm:tatamasmin:tatamayoH:tatamezu:tatama:tatamO:tatame
tatama,n_pron	tatamat:tatame:tatamAni:tatamat:tatame:tatamAni:tatamena:tatamAByAm:tatamEH:tatamasmE:tatamAByAm:tatameByaH:tatamasmAt:tatamAByAm:tatameByaH:tatamasya:tatamayoH:tatamezAm:tatamasmin:tatamayoH:tatamezu:tatamat:tatame:tatamAni
tatara,f_pron	tatarA:tatare:tatarAH:tatarAm:tatare:tatarAH:tatarayA:tatarAByAm:tatarABiH:tatarasyE:tatarAByAm:tatarAByaH:tatarasyAH:tatarAByAm:tatarAByaH:tatarasyAH:tatarayoH:tatarAsAm:tatarasyAm:tatarayoH:tatarAsu:tatare:tatare:tatarAH
tatara,m_pron	tataraH:tatarO:tatare:tataram:tatarO:tatarAn:tatareRa:tatarAByAm:tatarEH:tatarasmE:tatarAByAm:tatareByaH:tatarasmAt:tatarAByAm:tatareByaH:tatarasya:tatarayoH:tatarezAm:tatarasmin:tatarayoH:tatarezu:tatara:tatarO:tatare
tatara,n_pron	tatarat:tatare:tatarARi:tatarat:tatare:tatarARi:tatareRa:tatarAByAm:tatarEH:tatarasmE:tatarAByAm:tatareByaH:tatarasmAt:tatarAByAm:tatareByaH:tatarasya:tatarayoH:tatarezAm:tatarasmin:tatarayoH:tatarezu:tatarat:tatare:tatarARi
tad,f_pron	sA:te:tAH:tAm:te:tAH:tayA:tAByAm:tABiH:tasyE:tAByAm:tAByaH:tasyAH:tAByAm:tAByaH:tasyAH:tayoH:tAsAm:tasyAm:tayoH:tAsu:se:te:tAH
tad,m_pron	saH:tO:te:tam:tO:tAn:tena:tAByAm:tEH:tasmE:tAByAm:teByaH:tasmAt:tAByAm:teByaH:tasya:tayoH:tezAm:tasmin:tayoH:tezu:sa:tO:te
tad,n_pron	tat:te:tAni:tat:te:tAni:tena:tAByAm:tEH:tasmE:tAByAm:teByaH:tasmAt:tAByAm:teByaH:tasya:tayoH:tezAm:tasmin:tayoH:tezu:tat:te:tAni
tyad,f_pron	syA:tye:tyAH:tyAm:tye:tyAH:tyayA:tyAByAm:tyABiH:tyasyE:tyAByAm:tyAByaH:tyasyAH:tyAByAm:tyAByaH:tyasyAH:tyayoH:tyAsAm:tyasyAm:tyayoH:tyAsu:sye:tye:tyAH
tyad,m_pron	syaH:tyO:tye:tyam:tyO:tyAn:tyena:tyAByAm:tyEH:tyasmE:tyAByAm:tyeByaH:tyasmAt:tyAByAm:tyeByaH:tyasya:tyayoH:tyezAm:tyasmin:tyayoH:tyezu:sya:tyO:tye
tyad,n_pron	tyat:tye:tyAni:tyat:tye:tyAni:tyena:tyAByAm:tyEH:tyasmE:tyAByAm:tyeByaH:tyasmAt:tyAByAm:tyeByaH:tyasya:tyayoH:tyezAm:tyasmin:tyayoH:tyezu:tyat:tye:tyAni
tva,f_pron	tvA:tve:tvAH:tvAm:tve:tvAH:tvayA:tvAByAm:tvABiH:tvasyE:tvAByAm:tvAByaH:tvasyAH:tvAByAm:tvAByaH:tvasyAH:tvayoH:tvAsAm:tvasyAm:tvayoH:tvAsu:tve:tve:tvAH
tva,m_pron	tvaH:tvO:tve:tvam:tvO:tvAn:tveRa:tvAByAm:tvEH:tvasmE:tvAByAm:tveByaH:tvasmAt:tvAByAm:tveByaH:tvasya:tvayoH:tvezAm:tvasmin:tvayoH:tvezu:tva:tvO:tve
tva,n_pron	tvam:tve:tvARi:tvam:tve:tvARi:tveRa:tvAByAm:tvEH:tvasmE:tvAByAm:tveByaH:tvasmAt:tvAByAm:tveByaH:tvasya:tvayoH:tvezAm:tvasmin:tvayoH:tvezu:tva:tve:tvARi
dakziRa,f_pron	dakziRA:dakziRe:dakziRAH:dakziRAm:dakziRe:dakziRAH:dakziRayA:dakziRAByAm:dakziRABiH:dakziRasyE:dakziRAByAm:dakziRAByaH:dakziRasyAH:dakziRAByAm:dakziRAByaH:dakziRasyAH:dakziRayoH:dakziRAsAm:dakziRasyAm:dakziRayoH:dakziRAsu:dakziRe:dakziRe:dakziRAH
dakziRa,m_pron	dakziRaH:dakziRO:dakziRAH/dakziRe:dakziRam:dakziRO:dakziRAn:dakziRena:dakziRAByAm:dakziREH:dakziRasmE:dakziRAByAm:dakziReByaH:dakziRAt/dakziRasmAt:dakziRAByAm:dakziReByaH:dakziRasya:dakziRayoH:dakziRezAm:dakziRe/dakziRasmin:dakziRayoH:dakziRezu:dakziRa:dakziRO:dakziRAH/dakziRe
dakziRa,n_pron	dakziRam:dakziRe:dakziRAni:dakziRam:dakziRe:dakziRAni:dakziRena:dakziRAByAm:dakziREH:dakziRasmE:dakziRAByAm:dakziReByaH:dakziRAt/dakziRasmAt:dakziRAByAm:dakziReByaH:dakziRasya:dakziRayoH:dakziRezAm:dakziRe/dakziRasmin:dakziRayoH:dakziRezu:dakziRa:dakziRe:dakziRAni
dvi,f_pron	:dve:::dve:::dvAByAm:::dvAByAm:::dvAByAm:::dvayoH:::dvayoH:::dve:
dvi,m_pron	:dvO:::dvO:::dvAByAm:::dvAByAm:::dvAByAm:::dvayoH:::dvayoH:::dvO:
dvi,n_pron	:dve:::dve:::dvAByAm:::dvAByAm:::dvAByAm:::dvayoH:::dvayoH:::dve:
nema,f_pron	nemA:neme:nemAH:nemAm:neme:nemAH:nemayA:nemAByAm:nemABiH:nemasyE:nemAByAm:nemAByaH:nemasyAH:nemAByAm:nemAByaH:nemasyAH:nemayoH:nemAsAm:nemasyAm:nemayoH:nemAsu:neme:neme:nemAH
nema,m_pron	nemaH:nemO:nemAH/neme:nemam:nemO:nemAn:nemena:nemAByAm:nemEH:nemasmE:nemAByAm:nemeByaH:nemAt:nemAByAm:nemeByaH:nemasya:nemayoH:nemezAm:neme:nemayoH:nemezu:nema:nemO:nemAH/neme
nema,n_pron	nemam:neme:nemAni:nemam:neme:nemAni:nemena:nemAByAm:nemEH:nemasmE:nemAByAm:nemeByaH:nemAt:nemAByAm:nemeByaH:nemasya:nemayoH:nemezAm:neme:nemayoH:nemezu:nema:neme:nemAni
para,f_pron	parA:pare:parAH:parAm:pare:parAH:parayA:parAByAm:parABiH:parasyE:parAByAm:parAByaH:parasyAH:parAByAm:parAByaH:parasyAH:parayoH:parAsAm:parasyAm:parayoH:parAsu:pare:pare:parAH
para,m_pron	paraH:parO:parAH/pare:param:parO:parAn:pareRa:parAByAm:parEH:parasmE:parAByAm:pareByaH:parAt/parasmAt:parAByAm:pareByaH:parasya:parayoH:parezAm:pare/parasmin:parayoH:parezu:para:parO:parAH/pare
para,n_pron	param:pare:parARi:param:pare:parARi:pareRa:parAByAm:parEH:parasmE:parAByAm:pareByaH:parAt/parasmAt:parAByAm:pareByaH:parasya:parayoH:parezAm:pare/parasmin:parayoH:parezu:para:pare:parARi
pUrva,f_pron	pUrvA:pUrve:pUrvAH:pUrvAm:pUrve:pUrvAH:pUrvayA:pUrvAByAm:pUrvABiH:pUrvasyE:pUrvAByAm:pUrvAByaH:pUrvasyAH:pUrvAByAm:pUrvAByaH:pUrvasyAH:pUrvayoH:pUrvAsAm:pUrvasyAm:pUrvayoH:pUrvAsu:pUrve:pUrve:pUrvAH
pUrva,m_pron	pUrvaH:pUrvO:pUrvAH/pUrve:pUrvam:pUrvO:pUrvAn:pUrveRa:pUrvAByAm:pUrvEH:pUrvasmE:pUrvAByAm:pUrveByaH:pUrvAt/pUrvasmAt:pUrvAByAm:pUrveByaH:pUrvasya:pUrvayoH:pUrvezAm:pUrve/pUrvasmin:pUrvayoH:pUrvezu:pUrva:pUrvO:pUrvAH/pUrve
pUrva,n_pron	pUrvam:pUrve:pUrvARi:pUrvam:pUrve:pUrvARi:pUrveRa:pUrvAByAm:pUrvEH:pUrvasmE:pUrvAByAm:pUrveByaH:pUrvAt/pUrvasmAt:pUrvAByAm:pUrveByaH:pUrvasya:pUrvayoH:pUrvezAm:pUrve/pUrvasmin:pUrvayoH:pUrvezu:pUrva:pUrve:pUrvARi
Bavat,m_pron	BavAn:BavantO:BavantaH:Bavantam:BavantO:BavataH:BavatA:BavadByAm:BavadBiH:Bavate:BavadByAm:BavadByaH:BavataH:BavadByAm:BavadByaH:BavataH:BavatoH:BavatAm:Bavati:BavatoH:Bavatsu:Bavan:BavantO:BavantaH
Bavat,n_pron	Bavat:BavatI:Bavanti:Bavat:BavatI:Bavanti:BavatA:BavadByAm:BavadBiH:Bavate:BavadByAm:BavadByaH:BavataH:BavadByAm:BavadByaH:BavataH:BavatoH:BavatAm:Bavati:BavatoH:Bavatsu:Bavat:BavatI:Bavanti
Bavat,f_pron	BavatI:BavatyO:BavatyaH:BavatIm:BavatyO:BavatIH:BavatyA:BavatIByAm:BavatIBiH:BavatyE:BavatIByAm:BavatIByaH:BavatyAH:BavatIByAm:BavatIByaH:BavatyAH:BavatyoH:BavatInAm:BavatyAm:BavatyoH:BavatIzu:Bavati:BavatyO:BavatyaH
yatama,f_pron	yatamA:yatame:yatamAH:yatamAm:yatame:yatamAH:yatamayA:yatamAByAm:yatamABiH:yatamasyE:yatamAByAm:yatamAByaH:yatamasyAH:yatamAByAm:yatamAByaH:yatamasyAH:yatamayoH:yatamAsAm:yatamasyAm:yatamayoH:yatamAsu:yatame:yatame:yatamAH
yatama,m_pron	yatamaH:yatamO:yatame:yatamam:yatamO:yatamAn:yatamena:yatamAByAm:yatamEH:yatamasmE:yatamAByAm:yatameByaH:yatamasmAt:yatamAByAm:yatameByaH:yatamasya:yatamayoH:yatamezAm:yatamasmin:yatamayoH:yatamezu:yatama:yatamO:yatame
yatama,n_pron	yatamat:yatame:yatamAni:yatamat:yatame:yatamAni:yatamena:yatamAByAm:yatamEH:yatamasmE:yatamAByAm:yatameByaH:yatamasmAt:yatamAByAm:yatameByaH:yatamasya:yatamayoH:yatamezAm:yatamasmin:yatamayoH:yatamezu:yatamat:yatame:yatamAni
yatara,f_pron	yatarA:yatare:yatarAH:yatarAm:yatare:yatarAH:yatarayA:yatarAByAm:yatarABiH:yatarasyE:yatarAByAm:yatarAByaH:yatarasyAH:yatarAByAm:yatarAByaH:yatarasyAH:yatarayoH:yatarAsAm:yatarasyAm:yatarayoH:yatarAsu:yatare:yatare:yatarAH
yatara,m_pron	yataraH:yatarO:yatare:yataram:yatarO:yatarAn:yatareRa:yatarAByAm:yatarEH:yatarasmE:yatarAByAm:yatareByaH:yatarasmAt:yatarAByAm:yatareByaH:yatarasya:yatarayoH:yatarezAm:yatarasmin:yatarayoH:yatarezu:yatara:yatarO:yatare
yatara,n_pron	yatarat:yatare:yatarARi:yatarat:yatare:yatarARi:yatareRa:yatarAByAm:yatarEH:yatarasmE:yatarAByAm:yatareByaH:yatarasmAt:yatarAByAm:yatareByaH:yatarasya:yatarayoH:yatarezAm:yatarasmin:yatarayoH:yatarezu:yatarat:yatare:yatarARi
yad,f_pron	yA:ye:yAH:yAm:ye:yAH:yayA:yAByAm:yABiH:yasyE:yAByAm:yAByaH:yasyAH:yAByAm:yAByaH:yasyAH:yayoH:yAsAm:yasyAm:yayoH:yAsu:ye:ye:yAH
yad,m_pron	yaH:yO:ye:yam:yO:yAn:yena:yAByAm:yEH:yasmE:yAByAm:yeByaH:yasmAt:yAByAm:yeByaH:yasya:yayoH:yezAm:yasmin:yayoH:yezu:ya:yO:ye
yad,n_pron	yat:ye:yAni:yat:ye:yAni:yena:yAByAm:yEH:yasmE:yAByAm:yeByaH:yasmAt:yAByAm:yeByaH:yasya:yayoH:yezAm:yasmin:yayoH:yezu:yat:ye:yAni
yuzmad,m_pron	tvam:yuvam/yuvAm:yUyam:tvAm/tvA:yuvAm/vAm:yuzmAn/vaH:tvayA:yuvAByAm:yuzmABiH:tuByam/te:yuvAByAm/vAm:yuzmaByam/vaH:tvat/tvattaH:yuvAByAm:yuzmat:tava/te:yuvayoH/vAm:yuzmAkam/vaH:tvayi:yuvayoH:yuzmAsu:tvam:yuvam/yuvAm:yUyam
viSva,f_pron	viSvA:viSve:viSvAH:viSvAm:viSve:viSvAH:viSvayA:viSvAByAm:viSvABiH:viSvasyE:viSvAByAm:viSvAByaH:viSvasyAH:viSvAByAm:viSvAByaH:viSvasyAH:viSvayoH:viSvAsAm:viSvasyAm:viSvayoH:viSvAsu:viSve:viSve:viSvAH
viSva,m_pron	viSvaH:viSvO:viSve:viSvam:viSvO:viSvAn:viSveRa:viSvAByAm:viSvEH:viSvasmE:viSvAByAm:viSveByaH:viSvasmAt:viSvAByAm:viSveByaH:viSvasya:viSvayoH:viSvezAm:viSvasmin:viSvayoH:viSvezu:viSva:viSvO:viSve
viSva,n_pron	viSvam:viSve:viSvARi:viSvam:viSve:viSvARi:viSveRa:viSvAByAm:viSvEH:viSvasmE:viSvAByAm:viSveByaH:viSvasmAt:viSvAByAm:viSveByaH:viSvasya:viSvayoH:viSvezAm:viSvasmin:viSvayoH:viSvezu:viSva:viSve:viSvARi
sama,f_pron	samA:same:samAH:samAm:same:samAH:samayA:samAByAm:samABiH:samasyE:samAByAm:samAByaH:samasyAH:samAByAm:samAByaH:samasyAH:samayoH:samAsAm:samasyAm:samayoH:samAsu:same:same:samAH
sama,m_pron	samaH:samO:samAH/same:samam:samO:samAn:samena:samAByAm:samEH:samasmE:samAByAm:sameByaH:samAt:samAByAm:sameByaH:samasya:samayoH:samezAm:same:samayoH:samezu:sama:samO:samAH/same
sama,n_pron	samam:same:samAni:samam:same:samAni:samena:samAByAm:samEH:samasmE:samAByAm:sameByaH:samAt:samAByAm:sameByaH:samasya:samayoH:samezAm:same:samayoH:samezu:sama:same:samAni
sarva,f_pron	sarvA:sarve:sarvAH:sarvAm:sarve:sarvAH:sarvayA:sarvAByAm:sarvABiH:sarvasyE:sarvAByAm:sarvAByaH:sarvasyAH:sarvAByAm:sarvAByaH:sarvasyAH:sarvayoH:sarvAsAm:sarvasyAm:sarvayoH:sarvAsu:sarve:sarve:sarvAH
sarva,m_pron	sarvaH:sarvO:sarve:sarvam:sarvO:sarvAn:sarveRa:sarvAByAm:sarvEH:sarvasmE:sarvAByAm:sarveByaH:sarvasmAt:sarvAByAm:sarveByaH:sarvasya:sarvayoH:sarvezAm:sarvasmin:sarvayoH:sarvezu:sarva:sarvO:sarve
sarva,n_pron	sarvam:sarve:sarvARi:sarvam:sarve:sarvARi:sarveRa:sarvAByAm:sarvEH:sarvasmE:sarvAByAm:sarveByaH:sarvasmAt:sarvAByAm:sarveByaH:sarvasya:sarvayoH:sarvezAm:sarvasmin:sarvayoH:sarvezu:sarva:sarve:sarvARi
sima,f_pron	simA:sime:simAH:simAm:sime:simAH:simayA:simAByAm:simABiH:simasyE:simAByAm:simAByaH:simasyAH:simAByAm:simAByaH:simasyAH:simayoH:simAsim:simasyAm:simayoH:simAsu:sime:sime:simAH
sima,m_pron	simaH:simO:simAH/sime:simam:simO:simAn:simena:simAByAm:simEH:simasmE:simAByAm:simeByaH:simAt:simAByAm:simeByaH:simasya:simayoH:simezAm:sime:simayoH:simezu:sima:simO:simAH/sime
sima,n_pron	simam:sime:simAni:simam:sime:simAni:simena:simAByAm:simEH:simasmE:simAByAm:simeByaH:simAt:simAByAm:simeByaH:simasya:simayoH:simezAm:sime:simayoH:simezu:sima:sime:simAni
sva,f_pron	svA:sve:svAH:svAm:sve:svAH:svayA:svAByAm:svABiH:svasyE:svAByAm:svAByaH:svasyAH:svAByAm:svAByaH:svasyAH:svayoH:svAsAm:svasyAm:svayoH:svAsu:sve:sve:svAH
sva,m_pron	svaH:svO:svAH/sve:svam:svO:svAn:svena:svAByAm:svEH:svasmE:svAByAm:sveByaH:svAt/svasmAt:svAByAm:sveByaH:svasya:svayoH:svezAm:sve/svasmin:svayoH:svezu:sva:svO:svAH/sve
sva,n_pron	svam:sve:svAni:svam:sve:svAni:svena:svAByAm:svEH:svasmE:svAByAm:sveByaH:svAt/svasmAt:svAByAm:sveByaH:svasya:svayoH:svezAm:sve/svasmin:svayoH:svezu:sva:sve:svAni
ekEkA,f_pron	ekEkA:ekEke:ekEkAH:ekEkAm:ekEke:ekEkAH:ekEkayA:ekEkAByAm:ekEkABiH:ekEkAyE:ekEkAByAm:ekEkAByaH:ekEkAyAH:ekEkAByAm:ekEkAByaH:ekEkAyAH:ekEkayoH:ekEkAnAm:ekEkAyAm:ekEkayoH:ekEkAsu:ekEke:ekEke:ekEkAH
ekEka,m_pron	ekEkaH:ekEkO:ekEkAH:ekEkam:ekEkO:ekEkAn:ekEkena:ekEkAByAm:ekEkEH:ekEkAya:ekEkAByAm:ekEkeByaH:ekEkAt:ekEkAByAm:ekEkeByaH:ekEkasya:ekEkayoH:ekEkAnAm:ekEke:ekEkayoH:ekEkezu:ekEka:ekEkO:ekEkAH
ekEka,n_pron	ekEkam:ekEke:ekEkAni:ekEkam:ekEke:ekEkAni:ekEkena:ekEkAByAm:ekEkEH:ekEkAya:ekEkAByAm:ekEkeByaH:ekEkAt:ekEkAByAm:ekEkeByaH:ekEkasya:ekEkayoH:ekEkAnAm:ekEke:ekEkayoH:ekEkezu:ekEka:ekEke:ekEkAni
